w=24
h=24
dir=345
################        
#S             #########
#    ########  ##  ^   #
#    #m^    A   A    ^ #
#    #m     #  ##      #
#    ########  ######  #
#              ######  #
################    #  #
 ###############^   A  #
 #h  ^  A    ^##    #  #
 #h     ##    #######  #
 #mb  ^ ##    ##    #  #
 #m    ^##    ## h  A  #
 #########   ^##    #  #
###########  ########  #
#      #     ^#######  #
#  ^   B       ^       #
#      #            ^  #
#   ^  ##@##############
#     ^##  #----#  h####
# #######       @   A ^#
# ###############B#### #
# A  ^            #  # #
###################  #X#

EEE5EEE5EEE5EEEE00000000
E00000000000000577C77777
500006666666600E70000007
E00006444444000000000007
E00006444444600E70D00007
500006666666600577C77007
E0000000D000000E5E5EC00C
EEE5EEE5EEE5EEEE99997007
0AAAAAAAA777777F99990007
0A9999990000007E9999B007
0A999999A700007E5E5E7007
0A999999AC0000CE99997007
0A999999A700007F99990007
0AAAAAAAA700D07E9999B007
777C77777770077E5E5EC00C
700000070000007C77777007
7000D0000000000000000007
C00000070000000000000007
70000007777C777777C77777
B00000077111111170007EEE
707C7777111111117000022E
7071111111111111107C7E2E
700111111111111111100E2E
777111111111111111100EEE
