w=49
h=25
dir=345
#################################################
#S      |   #      mmhh#              #  ^   ^  #
#       |c  A          B ^          ^ C    ^    X
#       |   #          #              #^ ^   ^  #
##A## #-+---######################A#####-------##
#  ##   |   ###################      ^   ^      #
#  ##   |                     #h##  ## ^##  ##  #
#  ##  ^|  ^##   ^   ^    ^   #^##  ## m##  ##  #
#  ##^  |   ##                #          ^      #
#  ##   |   ##                ################# #
#  ##   | ^ ##                ################# #
#  ##   |   ##                ##h    ^      ### #
#  ##   |   ##   ^   ^    ^   ###A###A###A##h## #
#  ##   |   ##                ## ^ #m m#   #h## #
#  ##   #   ################*###   #m  #mbm#h## #
#  ##       #####################A### ###### ## #
#  ##       #          #   #   #   #   ####m ## #
#  ##                                H A  @  ## #
#  ##########          #   #   #   #   ####mm## #
#  ############################################ #
#  ^        #          ######################## #
#      ^    A  ^     ^ A          #m     ^      #
#    #@##   #          ###### ##### # # # # #^# #
#    # m#################^^  h   ^              #
###### ######           #########################

111111111111111111111111EEE5EEEE5EEEE5EEEE5EEEEEE
14444444444414444444444100000D00000000E000000000E
144444444444444444444440000000000000000000000D00E
14444444444414444444444100000000000000E000000000E
114114144444111111111111EEE5EEEE5E0EE5EE0000000EE
E88E144444441EEE5EEEE5EEEE5EEEE00000000000000000E
E88E14444444444444444444444444E0E500E5D0E500E500E
E88E144444441E4444444444444444E0EE00EE00EE00EE00E
5885144444441E4444444444444444E00000000000000000E
E88E144444441544444444444444445EEEEEEEEEEEEEEE505
E88E144444441E4444444444444444E666666666666666E0E
E88E144444441E4444444444444444E622222222222266E0E
E88E144444441E4444444444444444E662666266626626E0E
5885144444441E4444444444444444E622262226222626E0E
E88E144414441EEE5EEEE5EEEE5EEEE622262226222626505
E88E144444441111111111116666666662666266666626E0E
E88E144444441444444444412226222622262226666226E0E
E88E144444444444444444442222222222222222226226E0E
5885111111111444444444412226222622262226666226E0E
E88EEE5EEEEEE111111111116666666666666666666666505
E88888888888E44444444441EEEEEEEEEEEEEEEEEEEEEEE0E
E888888888888444444444440000000000E0000000000000E
E8888E5EE888E44444444441EEEEE0EEEEE0505050505050E
58888E88EEEEE11111111111E00000000000000000000000E
EEEEEE8EEEEEE00000000000EEEE5E5EEEEEEEEEEEEEEEEEE
