w=24
h=24
dir=270
########################
#h   B  ## h#   # d#hmm#
#    #  ##  # S #  #   #
#    # ^##  #   #  #   #
#   ^#  ##^ #   # ^# ^ #
#    #  ##  #   #  #   #
# ^  #  ##  #   #  #   #
#    #^ X#^ A   A  #   #
#    #  ##  #   #  #^  #
#    ######### ######A##
#  ^ #  #    # #       #
#    #  #    # #   ^   #
#    #  # ^  # #  #*#^ #
#   m####    # #  ###  #
#  ######   b# #       #
#  #    #    # #    ####
#  #^   A  # # # #  A  #
#  #  ###  #^# #m#  #  #
# ^#  ######## ###  #h #
#  #    #           # ^#
#  #    A           ####
#  ###########D###### H#
#        ^ ^    ^  m@  #
########################

EE5EEEEEE11111111111E5EE
E0022222E13313331331000E
50020502E13313331331000E
E2220E02E133133313310005
E2000E22513313331331000E
E2220E20E13313331331000E
50020522E13313331331000E
E0220E02E133333333310005
E0200E00E13313331331000E
E0222EEEE11111311111E3EE
50002533E333313133333335
E0222E33E33331313333333E
E0200E33E333313133EEE33E
E0200EEEE333313133EEE335
500AAAAA533331313333333E
E00A0000E33331313333E5EE
E00A0000333131313133300E
E00A00AAE33131313133E00E
500A00AA5111113111335005
E00A0000E33333333333E00E
E00A0000333333333333EEEE
E00AAAAAE5EE5E3E5EE5E005
50000000000000000000E00E
E5EEE5EEE5EE5EEE5EE5E5EE
