w=32
h=32
dir=280
################################
#    #      ####       ##    ^ #
# S  # ^  ^ @  # ^     ##      #
#    #      #     #    ##  ##B##
##A######   #     #    ##  #   #
#       #   #######  ^ ##  # c #
#   #-# #   #    ^  #####  #  h#
#    m| #   #md   ^ #####B######
#   #-# #   #h      ##m    #  ^#
#       #   ##########h    C  ^#
#       #   ## #######     #  ^#
#   #-# #   ##       #     ##C##
#    m| ##A###@####  #     #   #
#   #-# #         #mh#^    #   X
#       #     #-# ######   #^^^#
#       #       | A @  #   #####
#       #     #-# # #  #  ^#####
#       #^        # #  #^     m#
#       # ^       # #mh#^     h#
####A######   #-# # ########   #
#^              | # #      #   #
#             #-# # # #### #   #
#     ^           # #^   # #   #
####D############## #### # #   #
#          # hh#^      # # #   #
#          #   # ##### # #^#   #
#          # mm# #^#  ^# # #^  #
# # #  # # # ### # # ### # ### #
# |^|  |^| #             #  b# #
# #-#  #-# ###################^#
#                              #
################################

111111111111111111111111EEEEEEEE
133331333333111122222221E000000E
133331333333222122222221E000000E
133331333333122222122221E00EE0EE
113111111333122222122221E00E000E
133333331333111111122221E00E000E
1333A3A31333122222221111E00E000E
133333331333122222221EEEE0EEEEEE
1333A3A31333122222221700000E000E
1333333313331111111117000000000E
133333331333170777777700000E000E
1333A3A31333170000000700000EE0EE
1333333317077C7777700700000E000E
1333A3A31000000000C00700000E000E
13333333100000A0A0777777000E000E
133333331000000000007007000EEEEE
13333333100000A0A070700700077777
13333333100000000070700700000007
133333331000000000C0700700000007
11113111111000A0A070777777770007
C0000000000000000070700000070007
70000000000000A0A070707777070007
700000000000000000C0700007070007
77C707C777C777C77770777707070007
70000000000700070000000707070007
70000000000700070777770707070007
C0000000000C000C0C0C000707070007
70A0A00A0A0707770707077707077707
70000000000700000000000007000707
70A0A00A0A07C77C7777777777777707
C0000000000000000000000000000007
777777777777C777C777C777C7777777
