w=20
h=20
dir=90
############X#######
#   #   #          #
# b #   #  ^     ^ #
# ^ # ^ #          #
#   #   #   ^      #
##A##   ########## #
#       |        # #
#       |   ^    # #
##### ### ###### B #
#   # # # #^ ^ # ###
#   # #m# # ^  # ###
#^#h# # # #h   # #h#
# ### #A#B####A###h#
#                #m#
#                #m#
# ### ### ###### # #
#^#m# #^# #    # # #
#   # # # # ^    # #
#   # A #S#      @  
####################

777C7777EEFEEEFEE5EE
C3337333E9999999999E
73237333599999999995
73337333E9999999999E
73337333E9999999999E
77377333EEE5EE5EE595
73333333333333333E9E
73333333333333333E9E
777C737773777C77339E
C3337373737333373EEE
73337373737333373777
73737373737333373737
737C7373737C773C7737
C3333333333333333737
73333333333333333737
7377737C73777C773737
73737373737333373737
7333C373737333333737
C3337333737333333B33
77C77777777C777C7777
