w=51
h=24
dir=190
###################################################
#   ^    |          ^ #                       # |h#
#      ^ |            #          ^            # |m#
#        |    #####   #    ######           ^ # #m#
# ##@#---#  ###  S# ^ #    ##X  ###^ ######## # # #
# #  #     ##    ##   #^   ###  ^ ## #      # # #^#
# #  #  ^  #    ####  ### #####    # #      # # # #
# #  #     #   ######C###@######  ^# ##@##  # # #^#
# #  ##### #  ##b###   ##   #####  #     #  # # # #
# #    hm# #  #   #    ##   @  ##  #     #^^# # #^#
# #    hm# #  B   @ #########  ##^ #     #mc# # # #
# ######## # ##---# #######    ### #  ^  #### # #^#
#    |     # #   m# ###mm##   #### #          # # #
#    |     # A    # ^##hh    ##  B #          # |^#
#    |    ####    #m###     ##   ###^         # | #
#    |   ####^    ###^#######     #####       # |^#
##A#@##A####       ##    m##       ###        # |^#
## # h# ###    ^    ##  m##  ^      #         # |^#
## # m# ##^         ^@  ##                    # |^#
##A####A###A###@###A#####                     # |^#
#   ^       ##   ##                           # # #
#           ##   ##                           #   #
#   ^       ## H ##                          m@  ##
###################################################

EEEEEEEEEEEEEE1111111111111100000000000000000000000
E44444444444440000000014444400000000000000000000000
E44444444444440000000014444400000000000000000000000
E4444444444444EEEEE000144441EEEEE000000000000000000
E49999444E44EEE000F000144441F000EEE0099999999000000
E4944944444EE0000EE000144441EE0000EE092222229000000
E4944944444E0000EE77001114111EE0000E092222229000000
E4944944444E000EE7777071111111EE000E099999229000000
E4944999994E00EE077C00071444111EE00E000209229000000
E4944444494E00E00070000714441441E00E000209229000000
E4944444494E000000B07C7711111441E00E000209229000000
E4999999994E0EE00070221112244441EE0E000209999000000
E4444444444E0E000070221442244410EE0E000200000000000
E4444444444E00000070071444444100000E000200000000000
E444444444EEEE0000707714444410000EEE000200000000000
E44444444EE77000007770111111000000EEEEE000000000000
EE4EEEE4EE7C0000000C700000100000000EEE0000000000000
EE4E44E4E770000000007700010000000000E00000000000000
770744707700000000000700100000000000000000000000000
770777707770777777707777700000000000000000000000000
700000000000732223700000000000000000000000000000000
700000000000C32223700000000000000000000000000000000
700000000000732223700000000000000000000000000000000
77C7777C7777733333777777700000000000000000000000000
